# Number of times each instruction is exectued in deme 0
# Thu Mar 19 23:51:36 2026
#  1: update
#  2: Inst 0
#  3: Inst 1
#  4: Inst 2
#  5: Inst 3
#  6: Inst 4
#  7: Inst 5
#  8: Inst 6
#  9: Inst 7
# 10: Inst 8
# 11: Inst 9
# 12: Inst 10
# 13: Inst 11
# 14: Inst 12
# 15: Inst 13
# 16: Inst 14
# 17: Inst 15
# 18: Inst 16
# 19: Inst 17
# 20: Inst 18
# 21: Inst 19
# 22: Inst 20
# 23: Inst 21
# 24: Inst 22
# 25: Inst 23
# 26: Inst 24
# 27: Inst 25
# 28: Inst 26
# 29: Inst 27
# 30: Inst 28
# 31: Inst 29
# 32: Inst 30
# 33: Inst 31
# 34: Inst 32

0 0 0 0 0 0 0 0 0 0 0 0 0 0 0 0 0 0 0 0 0 0 0 0 0 0 0 0 0 0 0 0 0 0 
10 0 0 0 0 0 0 0 0 0 0 0 0 0 0 0 8 56 4 4 168 8 168 0 0 168 0 0 0 0 0 0 0 0 
20 42 0 0 0 0 0 0 0 0 0 0 0 0 0 0 30 210 15 15 588 30 588 0 0 588 0 0 0 0 0 0 0 0 
30 42 0 2 0 0 0 0 0 0 0 0 0 0 0 0 62 432 31 31 1258 62 1258 0 0 1258 0 0 0 0 0 0 0 0 
40 42 0 4 0 0 0 0 0 43 0 0 0 0 0 0 120 820 59 59 2434 118 2434 0 0 2437 0 0 0 0 0 0 0 0 
50 21 0 7 0 0 0 0 0 0 1 0 0 0 0 2 191 1317 95 95 3903 190 3901 0 0 3907 0 2 0 1 1 0 0 2 
60 0 0 9 0 0 2 2 0 0 0 0 2 0 0 1 199 1378 100 100 4184 200 4182 0 0 4191 1 4 2 3 0 0 0 4 
70 0 0 0 0 0 0 0 0 0 0 0 0 0 0 0 6 42 3 3 126 6 126 0 0 126 0 0 0 0 0 0 0 0 
80 2 0 0 0 0 0 0 0 0 0 0 0 0 0 2 16 120 9 9 378 18 378 0 0 378 0 0 2 0 0 0 0 0 
90 6 0 6 2 0 0 0 5 0 0 0 0 0 0 8 60 432 33 33 1382 66 1382 0 0 1384 0 0 6 0 0 4 0 0 
100 35 3 7 3 0 0 24 10 2 0 0 0 0 0 17 121 903 70 70 2892 144 2892 0 4 2897 0 2 17 0 0 4 0 0 
